#tilemap file
width: 32
height: 20
start: 7,2
end: 16,7
tileset: images/tileset.png 32,32,16
map_begin
11111111111111111111111111111111
11000000110000000000000000000111
11000000110111111111111110000111
11000000110111111111111110000111
11110111110111111111111110000111
11110111110111111111111110111111
11000000000111000000011110111111
11011111110111000000000000001111
11011111110111000000011111101111
11011111100011011111111111101111
11011000000011011000110001101111
11011011100000011000110001101111
11011011111111011000110001101111
11011011111111011101111011101111
11011000000000011101111011101111
11011111111111111101111011101111
11000000000000000001111011101111
11000111111111111111111011101111
11000111000000000000000000001111
11111111111111111111111111111111
map_end